{
  "target": 300,
  "rows": 8,
  "columns": 8,
  "hexCountPerCell": 7,
  "grid": [
    [1, 4, 2, 0, 3, 5, 6, 7],
    [2, 2, 4, 3, 0, 1, 5, 6],
    [3, 5, 1, 2, 4, 0, 7, 8],
    [0, 0, 0, 0, 0, 0, 0, 0],
    [1, 1, 1, 1, 1, 1, 1, 1],
    [5, 6, 7, 8, 1, 2, 3, 4],
    [7, 7, 7, 7, 7, 7, 7, 7],
    [8, 8, 8, 8, 8, 8, 8, 8]
  ]
}
